+-+-+-+-+-+-+-+-+-+-+-+-+-+-+-+-+-+-+-+-+
  |   |   |     |     |           |     |
+ + + + + +-+-+ + +-+ + +-+-+-+-+ + +-+ +
|   |   |     | | |   |     |     |   | |
+-+-+-+-+-+-+ + + + +-+-+ + + +-+-+-+ + +
|     |     | | | |     | | |         | |
+ +-+ + +-+ + + + +-+-+ +-+ +-+-+-+-+-+ +
|   | |   | | | |     | |     |     |   |
+-+ +-+-+ + + + +-+-+ +-+ +-+ + +-+-+ +-+
|         |   | |       | |   | |     | |
+-+-+ +-+-+-+-+ + +-+ + + +-+-+ + +-+-+ +
|     |       |   |   | |   |     |     |
+ +-+-+ +-+-+ +-+-+ +-+ +-+ + + +-+ +-+-+
|   |   |           |   |   | |       | |
+-+ + +-+ +-+ +-+-+-+-+-+ +-+ +-+-+ + + +
|   | |   |   |   |       |   |     |   |
+ +-+ +-+ + +-+ + + +-+-+-+ +-+ +-+-+-+-+
|   | |   |   | |   |       | |     |   |
+-+ +-+ +-+-+ + +-+-+ + +-+-+ +-+ + + + +
|       |       |     |       |   |   |  
+-+-+-+-+-+-+-+-+-+-+-+-+-+-+-+-+-+-+-+-+