+-+-+-+-+-+-+-+-+-+-+-+-+-+-+-+-+-+-+-+-+-+-+-+-+-+-+-+-+-+-+-+-+-+-+-+-+-+-+-+-+-+-+-+-+-+-+-+-+-+-+-+-+-+-+-+-+-+-+-+-+-+-+-+-+-+-+-+-+-+-+-+-+-+-+-+-+-+-+-+-+-+-+-+-+-+-+-+-+-+-+-+-+-+-+-+-+-+-+-+-+
        |     |   |     |   |     |   |   |   |           |     |           |   |   |   |   |     |   |         |               |   |     |   |   |     |     |   |     |   |       |   |   | |     |   |
+ +-+-+ + +-+ + + +-+ + + + +-+-+ + + +-+ +-+ + +-+-+-+-+ + +-+ +-+ +-+-+-+ +-+ + + +-+ + + +-+-+ +-+ + +-+-+ + + +-+-+ + +-+-+ + + + +-+ + + + + + +-+ + +-+ + + + +-+ + + + +-+-+ + + + + + + +-+ +-+ +
| |   |   | | | | |   | | | |   | | |   |   | |         |   | |   | |     |   |   |     | |     |       |   | |   |     | |   | | | | |   | |   |   |     | |   |   |   | |   |   |   |   | |     | |   |
+ + + + +-+ + + + + +-+ +-+ + + + + +-+ +-+ + + +-+-+-+-+-+-+ +-+ + + + + + + +-+ +-+-+-+-+-+-+ + +-+-+ + +-+ +-+-+ +-+-+ + +-+ + + + + +-+ +-+-+ +-+ +-+-+ +-+-+ +-+ +-+ + +-+ +-+ +-+-+-+ +-+-+-+ + +-+
| | |   |   | | |   | | |   | | | | |     | | | |   |   |   |   | | | | | | | |   |   |   |     | |   |   |   | |   |   | |     | |   |   | |   |   |         | |   |     |   |     |   |           |   |
+ +-+-+-+ +-+ + +-+-+ + + +-+ + + + +-+-+-+ + + + + + + + +-+ + + + + +-+ + + + +-+ + + + + +-+-+ + + +-+-+ +-+ + +-+ + + +-+-+-+ +-+-+-+ + + + +-+-+-+-+-+-+ + +-+ +-+-+-+-+ +-+-+-+-+ +-+-+-+-+-+-+ + +
|     |   |   |   |   | |     |   |   |   | | |   | | | |   | | |   |   | | |     | |   |   |   | | | |   | |     |   | |       |   |     | | |         |     |     |   |     |   |   |       |       | |
+-+-+ + +-+ +-+-+ + +-+ + +-+-+-+-+-+ + + + + +-+-+ +-+ +-+ + + +-+-+-+ + + +-+-+ + +-+-+-+-+ + + + + + + + + +-+-+ +-+ +-+-+ + +-+ + +-+-+ + +-+-+-+-+ + +-+-+-+-+ + + + + +-+-+ + + +-+-+-+ + +-+ +-+ +
|     |   |       |     | |   |     | | |   | |   |   |       |   |     | | |       |         |   | |   | | |     | |   |   | | |   |     | |       |   | |   |   | | | | | |   |   | |         |   |   |
+ +-+-+-+ +-+ + +-+-+ +-+ + + + + + + + +-+-+ + + +-+ +-+-+ +-+-+-+ +-+-+ +-+ +-+ +-+-+-+-+-+-+-+-+ +-+-+-+ +-+-+ + + +-+ + +-+ + +-+ + +-+ +-+-+ + +-+-+ +-+ + + +-+ + + +-+ + + +-+ + +-+-+-+-+ +-+-+-+
|       |   | |     |     | | | | |   |         |     |   |         | |       | |     |   |     |         |     |   | | | | |   |   | |     | |   |   | | |   | | |   | | |   |   |     |     |   |     |
+-+-+-+ +-+ +-+-+-+ +-+-+-+ + + + +-+-+ +-+-+ +-+-+-+-+ +-+-+ +-+-+-+ + + +-+-+ +-+-+ + + +-+-+ +-+ +-+-+ +-+ +-+-+-+ + + +-+ +-+-+ + +-+-+-+ + +-+-+ + + + +-+ + + +-+ + + +-+-+-+-+ +-+ +-+ +-+-+-+-+ +
| |       | |   | |       | | | |   |   | |   |         |   |       |   |     | |     | |     |       |   |   |     | | |     |   | |       |   |   | | | | |   |   |   | | |       | | |   | |       | |
+ + +-+-+-+ + + + +-+-+-+ + + + +-+ + +-+ + +-+ +-+-+-+-+ + +-+-+-+ +-+-+-+-+ + + +-+-+-+-+-+ +-+-+-+ + +-+ + + + + + + +-+-+ + + + +-+-+-+-+-+-+ + + + + + + +-+-+-+-+-+ + +-+ + + + + +-+ + + +-+ +-+ +
| |       |   | |   |       |   |     |     | |           |         |       |   |   |   |     | |   | |     | | | |     |   | | | |         |   | |   |   | | |         | |     | | | |     |   | |   | |
+ + +-+-+ + +-+ +-+ + + +-+-+-+-+ + +-+-+ +-+ +-+-+-+-+-+-+-+-+-+-+-+ +-+-+ +-+-+-+ +-+ +-+ +-+ + +-+ +-+-+-+-+ +-+-+ +-+ + +-+ + +-+-+-+-+ +-+ + +-+-+-+-+ + + +-+-+-+ + +-+-+-+-+ + + +-+-+-+-+ +-+ + +
|   |     | |   | | | |   |   |   | |     |   |       |       |     | |     |     |       |     |     |         |     |   | |   | |       | |   | |         |   |     | | |         | | |     |     | | |
+ + + +-+-+-+ +-+ + + +-+ +-+ + + + +-+-+-+ + + +-+-+ + + +-+-+ +-+ + + +-+-+ +-+ +-+-+ + +-+-+ + +-+-+ +-+-+-+-+ +-+-+ +-+ + +-+ +-+-+-+ + + + + + +-+-+-+-+-+-+ +-+ + + +-+-+ +-+-+ + + +-+ +-+ +-+ + +
| | |           | | |   | |   | | |       | |   |     | |     |   |   |   |     | |   | |     | |     | |     | |       |   | | | |     |     | | |         |     |   | |     | |   | | | | | |   |   | |
+-+ +-+-+-+-+-+ + + +-+-+ + +-+ +-+-+ +-+ + +-+ + +-+ + +-+-+ + + +-+-+-+ +-+-+ + + +-+ +-+-+ + +-+-+ + + +-+ + +-+-+-+-+ +-+ + + + +-+ + + +-+ + +-+-+-+-+ + +-+-+ +-+ +-+-+ + + + + + + + + + + + +-+ +
|   |           | | |   | |     |   | |   |   | |   | |     |   | |     |   |   | |     | |   |       |   |   |     |     |   |     | | | |   |   |     | | |     |   |   | |   | |   |   |   | |     | |
+ +-+ +-+-+-+-+-+ + + + +-+ + +-+ + + + +-+-+ + +-+ + +-+-+ +-+-+ + +-+ + + + +-+ +-+-+ + + +-+ +-+-+-+-+-+ +-+ +-+ + +-+-+-+-+-+ +-+ + + + +-+-+-+-+-+ + + +-+-+ +-+ +-+ + +-+-+ +-+-+ +-+-+-+ + +-+-+ +
| | | |       |   |   |     |   | |   | | |   | |   | |     |     |   | | | |   |     | | |     |       | |   |   | |     |     |     | | |   |         | | |   | | |       |     |   | |     | |   |   |
+ + + +-+ +-+ + +-+ + + +-+-+-+-+ +-+-+ + + +-+-+ +-+-+ +-+-+ + +-+-+ + +-+ +-+-+-+-+ + + +-+-+-+ +-+-+ + +-+ +-+ +-+ +-+ + + + +-+-+-+ + +-+ + +-+-+-+-+ + + + + + +-+-+-+-+ +-+-+-+ + + +-+ + +-+ + +-+
|   |     |   | |   | | |         |   | | | |   |   |   |   | | |   | |   | |   |   |   |         |   | | |   | |     |   | | |     | | | |   |         |     |   | |     |   |     | | | |   | | | |   |
+-+ +-+-+-+ +-+ +-+-+-+ + +-+ +-+-+ +-+ + + + + +-+ + +-+ + + + +-+ + +-+ +-+ + + +-+-+-+-+ +-+-+-+-+ + + + + + +-+ +-+ +-+ + +-+-+ + + + + +-+-+ +-+-+-+-+ +-+-+-+ +-+-+ + +-+ +-+ + + + + +-+ + + +-+ +
|   |       |     |     |   |     |     |   | |     |   | | | |     |   |     | | |         |         |     | |   |   |   | |     | |   | | |   | |         |       |     | |   |   |   | |     | |   | |
+ +-+ +-+-+ + +-+ + +-+-+-+ +-+-+ +-+-+-+-+ + +-+-+-+-+ + +-+ +-+-+-+-+ +-+-+-+ + + +-+-+-+ + +-+-+-+-+-+ +-+ +-+ +-+ +-+-+ +-+-+ +-+ +-+-+ + + + + +-+-+-+ +-+-+ + + + +-+ + +-+ +-+-+-+ +-+-+-+ +-+ + +
|   | |   | |   |   |     |     |   |   |   |   |     | |     |       | |   |   | |     | | |           |   |   |     |   |   |   |   |       |   | |     | |     | | |     |   | | |       |   | | |   |
+-+ + + + +-+-+ +-+-+-+-+ +-+-+ + + +-+ + +-+-+ + +-+ +-+ +-+-+ +-+-+ + +-+ + +-+ +-+-+ + + +-+-+-+-+-+ +-+ +-+ +-+-+-+ + +-+ +-+ + +-+ +-+-+-+-+-+ + +-+ + + +-+-+-+ +-+-+-+-+ + + + +-+-+-+ + + + +-+-+
| | |   | |   | |     |         | |     | |   |   |       |   | |   | |   | |   |   |   |   |   | |   |     | |   |   | |   |   |   |   |   |   |   | |   | | |       |       | | | | | |     | | |     |
+ + +-+-+ + + + + +-+ + + +-+-+-+-+-+-+-+ + +-+-+-+-+-+-+-+ + + + +-+ +-+ + +-+ + +-+ +-+-+-+ + + + + +-+-+-+ +-+ + + + +-+ +-+ +-+-+ +-+ + + + + +-+ + + + + + +-+-+-+ +-+-+ + + + + + + +-+-+ + + +-+ +
|   |   | | | | |   | | |   |     |     | |         |       | |   |       |     | |   |     | | |   | |   | |       |   |       |     | | |   |   |   | | |   |     |   |   | | | |   | | |   |   |   | |
+-+-+ +-+ + +-+ + + + +-+-+ + +-+ + +-+ + +-+-+-+-+ + +-+ + +-+-+-+ +-+-+-+ +-+-+ + +-+-+-+ + + +-+-+ + + + +-+-+ + +-+-+ +-+-+-+ +-+-+ + +-+-+-+-+-+-+ + +-+-+-+ +-+ + + + + + + +-+ + + +-+ +-+ +-+-+ +
|   | |   |     | | |         |   | |   | |     | |   |   | |   |   |   | | |   | | |     | | |   |     | | |     | |   |   |     |   | |   |     |     |   |   |     | | |   | |     | | |       |     |
+-+ + + +-+ +-+-+ + +-+-+-+-+-+ +-+ + +-+ + +-+ + +-+-+ +-+ + + + +-+ + + + + + + + + + +-+ + +-+ + +-+-+ + + +-+-+-+ + +-+ + +-+-+ + + +-+ + +-+ + +-+-+-+ + + +-+-+-+ + +-+-+ +-+-+-+ + + +-+-+-+ +-+-+
|   |     | | |   | |         | |   |   | |   | |     |   |   | |     |   |   |     | | |   | | | |   | |   |   |   | |   |   |     | | |     | | | |       | |       | |     |       |   | |       |   |
+ +-+-+-+-+ + + +-+-+ +-+-+-+ + + +-+-+ + +-+ + +-+-+ +-+ +-+ +-+-+-+-+-+-+-+-+-+ + +-+ + +-+ + + +-+ + +-+-+ + + + +-+ + +-+-+ +-+-+ + +-+ + + + + + +-+-+-+ +-+-+-+ +-+-+-+ +-+-+-+ +-+-+ + + +-+ + + +
| |       |   | |     |     |     |     |     | |   | | |   |           |   |   | |   | |   | | |     |   |   | | |   | | |   |     | | |   | | | | | |     | |     | |     |               | |   | | | |
+ + +-+-+ +-+-+ + +-+-+ +-+ +-+-+-+ +-+-+ +-+-+ + + + + +-+ +-+-+-+ + +-+ + + + + +-+ + +-+ + + +-+-+-+-+ + +-+ + +-+ + +-+ + +-+-+ +-+ + +-+-+ + + + + +-+ + + +-+ +-+ +-+ +-+-+-+-+ +-+-+-+ +-+-+ + + +
| | |     |     | |     |           |     |   |   |   |     |       |     |   |   |   | |       |   |   | |   | |   | |     |     |     | | |   |   |   | |   |   |     | |           | |     |     | | |
+ + +-+-+-+-+-+ + + +-+-+-+-+-+-+ + + +-+-+ + +-+-+-+-+-+-+-+ +-+-+-+-+-+-+-+-+-+ + +-+ + + +-+-+ + +-+ + + +-+ +-+ + +-+-+-+-+-+ +-+-+ + + + +-+-+-+-+-+ +-+-+-+ +-+-+-+ +-+-+-+-+-+-+ + +-+-+ +-+-+ + +
|   |           | | |     |   |   | |   |   |       |     |       |   |   |       | |   | | |     |     |   |   |   |       |   |         |   |       |   |     |   |       |   |       | |   |       | |
+ +-+ +-+-+-+-+-+ + + +-+ +-+ + +-+-+ + + +-+-+-+-+ + +-+ +-+-+ + + +-+ + +-+ +-+-+ + +-+-+ +-+-+ +-+-+-+-+-+ +-+ +-+-+-+-+ + +-+-+-+-+ +-+ +-+ +-+-+ + +-+-+-+ +-+ +-+ + + + + + +-+-+ + + + +-+-+-+-+ +
|   | |   |     | | |   |     |   |   |   |     |   | |   |   | |   |   | |   | |   | |     |       |   |       |       |     |         |   |   |   |   |         |   | | | | |   |     | | |   |       |
+ +-+ + + + +-+-+ + +-+ +-+-+-+-+ + +-+-+-+ + +-+ +-+-+ +-+ + +-+-+ + +-+ + +-+ + +-+ + +-+-+ +-+-+ + + + +-+-+-+-+-+-+-+ +-+ + +-+-+-+-+ +-+ +-+ + +-+-+ +-+-+-+ +-+ + + + + +-+-+ + +-+ + +-+ +-+-+-+-+
|     | |     |   |       |       |   |     |   | |       | |   |   | |   |     |     | |   | |   | | | |               |   |   | |     | |     | |     | |     | | |   | |     |   | | | |   |         |
+-+-+-+ + +-+ + +-+-+-+-+ + +-+-+-+ + + +-+-+-+ + + +-+ + + +-+ + +-+ + +-+-+ +-+-+-+-+ + + + + + + + +-+-+-+-+-+ +-+-+ +-+ +-+-+ + +-+ + + + + + +-+-+ + + +-+ + + +-+-+ +-+-+-+ +-+ + + +-+ +-+-+-+ + +
| |     | | | |   |       |   |   | | |   |   |   | | | |   |   |     | |   | |   |     | |   | | | |     |   |   |     | |       |   | | | | | |   |   | |   | |   |   | |       |   | |   | | |   | | |
+ + +-+-+ + + +-+ + +-+-+-+-+ + + + + +-+ + +-+-+-+ + + +-+-+ +-+-+-+-+ + + +-+ + + +-+-+ +-+-+ + +-+-+-+ + + + +-+ +-+-+ +-+ +-+ +-+-+ + + + + +-+-+ +-+-+-+ + + +-+ +-+ +-+-+-+-+ +-+ +-+ + + + + + + +
|   |   |   |     |         | | | | | |   | |   |   | |     | |   |     | |     | |       |   | |   |   |   |   |   |     |   |   |     | | | | |   | |     | |       |   |   | |   |       |   | | | | |
+-+-+ + +-+-+-+ +-+ +-+ +-+ + + + + + + +-+ + + + +-+ +-+-+ + +-+ + +-+-+ +-+-+-+-+-+ +-+-+ + + + + +-+ +-+-+-+-+ +-+ + + +-+ + +-+ +-+-+ +-+ + + + + +-+-+ + +-+-+-+-+ +-+ + + + +-+-+ + +-+-+-+ + +-+ +
|   | |         | | |   | | |   |   | |       | | |   |     |     | |     |         | |     |   | |     |   |   |     | |   | |   | | |   |   | | | |   |       | |       | | |   |   | | |   |   |     |
+ +-+ +-+-+-+ +-+ + +-+-+ + + +-+-+-+ +-+-+ +-+-+ + + + +-+-+-+-+-+ + + +-+-+-+ +-+ + + +-+-+-+-+ +-+-+-+ +-+ +-+-+-+-+-+-+ + +-+ + + + +-+ +-+ + + +-+ +-+-+ + + + +-+-+-+ + + +-+ + +-+ +-+ + +-+-+-+-+
|   |   | |   | | |   | |   |   |     |   |       | | | |     |       | |   | | | | | | |         | |       |               |   |   |       |   | |     |     |   | |   |   | |   | |   | |   | | |   | |
+-+ +-+ + + +-+ + +-+ + +-+-+-+ + +-+-+ + +-+-+-+-+-+ + + +-+ +-+-+-+ + + + + + + + + + +-+-+-+-+-+ + +-+-+ +-+-+ + +-+-+-+-+-+ +-+-+ + +-+-+ +-+ +-+-+-+ +-+-+-+-+ + + + +-+ +-+ + +-+ + + + + + + + + +
| |     |   | | |     |         | |   | |   |   |   | | |   |         |   | |   |     |     |         |   |     | |       |   |   |   | |         |   |   |   |   | | |   | |   |   | |     | | |   |   |
+ +-+-+ + +-+ + +-+-+-+ +-+-+-+-+ + + + +-+ +-+ + + + + +-+-+-+-+-+-+-+-+-+ +-+ +-+ +-+-+-+ +-+ +-+-+-+ + +-+-+ +-+-+-+-+ + + +-+ + +-+ + +-+-+-+-+ + + +-+ + + + + + +-+-+ +-+ +-+-+ +-+ +-+-+ +-+-+ +-+
|       | |   |         |   |     | | | |   |   | | | |       |       | |   |   |   |     |   |   |     | | |     |       | | |   |   | |   |     | |   |   |   | |   |   |     |     |   |   |   |     |
+-+-+-+-+ + + +-+-+-+-+-+ + + +-+-+ + + +-+-+ +-+ + + +-+-+-+ + +-+-+ + + +-+ + + +-+ +-+ +-+ +-+ + +-+-+ + + + + +-+ +-+-+ + + +-+-+-+ +-+-+ +-+ + +-+-+ +-+-+-+ +-+-+-+ +-+-+-+ + +-+ + + + + + +-+ +-+
|   |   |   | |       |   | | |   | | |     |     |     | |   | |       |     | |     | |     |   |     |     | |     |     |         | |     |   | |   |       | |   |   |       |     |   |   |   |   |
+ + + +-+-+-+ + +-+-+ + +-+ + + + + + +-+ +-+-+-+-+-+ + + + +-+ + +-+ +-+-+-+-+ +-+ +-+ +-+-+-+ +-+-+-+-+-+-+ + +-+-+-+ +-+-+-+-+-+-+ + + +-+-+ + + +-+ +-+-+-+ + + + + +-+-+ + +-+ +-+-+-+-+-+-+-+ +-+ +
| | |       |   |     | | |   | | | |   |       |   | |   |     | |   |   |     |   |     |       |   |   | | | |         |   |       | | |   | | | |     |   | | | |         |   | | |   |   |     |   |
+ + +-+-+ + +-+-+ +-+-+ + +-+-+-+ + +-+-+-+-+-+ + + + + +-+-+ +-+ +-+-+ + +-+-+ + +-+ +-+-+ +-+-+ + + + + + + + + +-+-+ + + + + +-+-+-+ + + +-+ +-+ + + +-+ + +-+ +-+-+ +-+-+-+-+ + + + +-+ + + +-+-+ +-+
| |     | |   |   |   | |   |   | | |   |   | | | |   | |       | |     |   |   | | | |   | |   | | |   | |   |   |   | | | | | |     |   | |   |   | |     |   | |     |   |     | |       | |     |   |
+-+-+-+ +-+ +-+ +-+-+ + +-+ + + + + + + +-+ + + + +-+-+ +-+-+-+ + + +-+-+-+ +-+-+ + + +-+ + + + + + +-+-+ +-+-+-+-+ + + + +-+ + + +-+ + +-+ + +-+ +-+ +-+-+-+-+ + + +-+-+-+ + +-+-+-+ +-+-+-+ +-+-+ +-+ +
|     | |       |   |   |   | | | | | |   |   | |   |   |   |   | | |   | |   |     |   | |   | |   |   |       |   | | |     |   | |   |       | |   |       |   |       | |   |   |     |   |     |   |
+ +-+ + + + +-+ + + + + + +-+-+ + + + +-+ +-+ + +-+ + + + + + +-+-+ + + + +-+ + +-+-+-+ + +-+-+ +-+-+ + +-+-+-+ + +-+ + +-+-+-+-+ + +-+-+ +-+-+-+ + +-+ +-+-+ +-+ +-+-+-+ + +-+ + + +-+-+-+ +-+ +-+-+ +-+
|   |   | |   | | | | | | |     | |     |   | |     | |   |   |     | |   | |   |     |       | |     |         | |   | |   |     | |   |     |   |   |   |   |   |     |   |   | |     |   |   |   |   |
+-+ +-+-+-+-+ +-+ + +-+ + + +-+-+ +-+ +-+-+ + +-+-+-+ +-+-+-+-+-+ +-+ +-+ + +-+-+ +-+ +-+ +-+ + + +-+-+-+-+ +-+-+ + + + + + + +-+-+ + +-+-+-+ + +-+-+ +-+ + +-+ +-+ +-+ +-+-+-+-+ +-+-+ + +-+ +-+ + + +-+
|       |     |   |       | |   |   |   | | |         |     |     |   | | | |   | | |     |   | |     |   |   |   | | | | |   |   |       |   | |   |     |   |   |   | |       |     | |     |   | |   |
+ + +-+-+ +-+-+ +-+-+-+ +-+ + +-+ + +-+ + + + + +-+-+-+ +-+ + +-+-+ +-+ + + + + + + +-+-+-+ +-+-+-+-+ + + +-+ +-+-+-+ + + +-+-+ +-+-+ +-+ + +-+ + +-+-+-+-+ + +-+ +-+ + + +-+ + +-+-+ + + +-+-+ +-+ +-+ +
| |     | |     |       |   |   | |   |   | | | |       | | |   |       |   | | | | | |   |           | |   | |       | | |   |   |   | |   |   |           |   | |   |   |   | |   | |     |     |     |
+-+-+ + + + +-+-+ +-+-+-+ +-+-+ +-+-+ +-+-+ + + + +-+-+-+ + +-+ +-+ +-+-+-+-+-+ + + + + +-+-+-+-+-+-+-+ +-+-+ + +-+-+-+ + +-+ +-+ + + + +-+-+ +-+-+ +-+-+-+-+-+-+ + +-+-+-+-+-+ + +-+ +-+-+-+ + +-+-+-+-+
|   | |   | |       |     |             |     |   |     | |   |   | | |       | | |   | |   |         | |     | |       |     |     |       |     |     |         | |         | |   |         |     |   |
+ + +-+-+-+ + +-+-+-+ +-+-+-+ +-+-+-+ + + + +-+-+ + +-+-+ +-+ + + + + + +-+-+ + + +-+ + + + + +-+-+-+ + + + +-+ + +-+-+-+-+-+-+-+ +-+-+-+-+ +-+-+ +-+-+ + +-+-+-+-+ + +-+-+-+ + +-+ +-+ +-+-+-+-+ + +-+ +
| |         | |       |     |       | |   | | |   |         | | |   | | |     | | | |     |   |   |     | | |   | | |       |     |   | |   |   |     | |       |   |       |   | |     |       | |     |
+ +-+-+-+-+-+ + +-+-+-+ +-+ +-+-+-+-+ +-+-+ + + + +-+-+-+ +-+ + +-+-+ + + + +-+ + + +-+-+-+-+-+ + + + +-+-+ + +-+ + + +-+-+ + +-+-+-+ + + +-+-+ +-+-+ + +-+ +-+ + +-+-+-+-+ +-+-+ +-+ +-+ +-+-+ +-+-+ +-+
|         |   |     |   | |         | |     |   | |     |     |         | |   | |     |     |   |   |     |     | |   | |   |   |     |   |   |     |   |   |   |   |           |     |   |   |         |
+-+-+-+-+ + +-+-+-+ + +-+ +-+-+-+-+ +-+ +-+-+-+-+-+ +-+ +-+ +-+ +-+ +-+-+ +-+ + +-+-+ + +-+ +-+-+-+-+-+-+ +-+-+ + +-+-+ + +-+-+ + + +-+-+-+ + +-+ + +-+-+ +-+ +-+-+ +-+-+-+-+-+ +-+-+-+ +-+ +-+-+-+-+-+ +
|         |         | | | |       |   | |   | |     | |     |   |   |   |   | | | |   |   |       |     |       | |     | | |   | | |     | |     |     | | | |   |   |   |   |   | |   |         |     |
+ +-+-+-+-+-+-+-+-+-+ + + + +-+-+ + + + + + + + +-+-+ +-+-+-+ +-+-+ + + +-+ + + + + +-+ + +-+-+-+ +-+-+ +-+-+-+-+ + + +-+ + + +-+-+ + +-+ + +-+-+ +-+-+-+ + + +-+ +-+ + + + +-+-+ + + +-+-+-+-+-+ + +-+-+
|     |     |   |   |         |   | |   | | | | |   | |     | |     | |     |   | | |   | |   |         |   |     | |     | |     | | |   |   | |       | | |   | |   | | |       |   |         |   |   |
+-+-+ +-+-+ + + + +-+-+-+ +-+ + +-+-+-+-+-+ + + +-+ + + +-+ + +-+-+-+-+-+-+-+-+-+ + + +-+ + + + +-+-+-+-+ + + +-+-+-+ +-+-+ +-+-+ + + +-+-+-+ + +-+-+-+ + + +-+ + + + + + +-+-+-+-+-+-+ +-+-+-+ + +-+ + +
|     |       | |     | |   | | |     |   | |   |   |   |   |   |       |         | |   | | |   |   | |   | |   |   |     | |       |   |   |       | |     | |   | |   | | |   |       |   | | |   | | |
+ +-+-+ +-+-+-+ +-+-+ + +-+ + + + +-+ + + + +-+ + +-+-+-+ +-+-+ + +-+-+ + +-+-+-+ + +-+-+ + +-+-+-+ + + +-+ +-+ + + + +-+-+ + +-+ +-+-+ +-+ +-+ + + + +-+-+-+ +-+-+ +-+-+ + + + + +-+-+-+ + + + +-+-+ + +
|     |     | | |   |     | | | | |   | |       | |     | |   | | |     | |     | | |   | |     |   | | | |   |   |   |       | | |   |   |   | | | |     |       | |     |   |         | |   |     | | |
+-+-+ +-+-+ + + + + +-+ + + + + + +-+ + +-+-+-+-+ + +-+ + + + + + + +-+-+-+ +-+ + + + + + + +-+ + +-+ + + +-+ +-+-+-+-+ +-+-+-+ + + + +-+ +-+ + + + + +-+ +-+ +-+ + +-+-+-+-+-+-+-+-+ + + +-+ +-+-+ + + +
|   |       | | | |     | | | | | |   |     |   | | | |     | |   |       |   | |   | |   | |   |   |   |     |       |       |   | | |   |     | | |   | |   |   |   |   |     |   | | |   |     | | | |
+ + +-+-+-+-+ + + +-+-+-+ + + + +-+ +-+-+-+ + + + + + +-+-+-+ +-+-+ +-+-+ +-+-+ +-+-+ +-+-+ + +-+-+ +-+-+ +-+-+-+ +-+ +-+-+-+ +-+-+ + +-+ + +-+-+ + +-+ + + +-+ +-+-+ +-+ + + +-+ +-+ +-+-+ +-+-+ + + + +
| | |   |   |   |     |   | | |   |     |   | | | |   |         |   |   | |   | |     |   | |     | |   | |     | | | |   |   |     |   |     |   | |   |   | | |   |   |   |   | |   |     |   |   | | |
+-+ +-+ + + +-+-+-+ +-+ +-+ + +-+ +-+-+ + +-+ + + +-+-+-+ +-+-+-+ +-+-+ + + + + + +-+-+ + + +-+-+ + +-+ + + +-+ + + + + +-+ +-+ +-+-+-+ +-+-+ + +-+ + +-+-+-+ + + + +-+ +-+-+-+ + + +-+ +-+-+ + +-+-+ + +
|   |   | |   |   |   |   | | |   |     |     |         |       | |       | |   | |   | |   |   | |   | |     | | |   |       | |     |       | | |   |   |   |   |       | |   |   | | |     |   | | | |
+ +-+ +-+ +-+ +-+ +-+ + + +-+ + +-+ +-+-+-+-+-+-+-+-+-+ +-+-+ + +-+ +-+-+ + +-+-+ +-+ + +-+-+ + + +-+ + +-+-+-+ + +-+ +-+-+ + + + +-+ + +-+-+-+ + +-+-+ + +-+ +-+-+-+ +-+ + + +-+ +-+ + + +-+ +-+ + + +-+
|     |     |     |   | |     |     |         |         | |   |   |   |   | |   | |   |       | |           |     | | |     |   | | | |     |   | |     | |     |   |   |   | |   |   | | | | |   |     |
+-+ +-+-+-+ +-+-+ + +-+-+-+ +-+-+-+-+ +-+-+-+ + +-+-+ +-+ + +-+-+ +-+ + +-+ + + + + +-+-+-+-+-+-+-+-+ +-+-+ + + +-+ + + +-+-+-+-+ + + +-+-+ + +-+ + +-+-+ + +-+ + +-+-+ +-+-+ + + + +-+ + + + + +-+-+ + +
| |     |   |   | |   |   | | |           | | | |   | |   |     |   | | |   | | | | |       | |       |   | | |   | | | |     |   |   |     |   |   |   | | |   |       |     | | | | |   | | | |   | | |
+ +-+ + +-+ + + + +-+ + + + + + +-+-+ +-+ + + + + + + + +-+-+-+ + +-+ + + +-+ + + + + +-+-+ + + + +-+-+ + +-+ +-+ + + + + +-+ + +-+-+-+-+-+-+ + +-+-+ + + + + +-+-+-+ +-+ + +-+ +-+ + +-+ + + + + + +-+ +
|     |     | |       | |   |   |     |     |   | |   |         |     |       |     |     |     |       |     |   |   |   |     |             |       | |   |             |         |     |   |   |      
+-+-+-+-+-+-+-+-+-+-+-+-+-+-+-+-+-+-+-+-+-+-+-+-+-+-+-+-+-+-+-+-+-+-+-+-+-+-+-+-+-+-+-+-+-+-+-+-+-+-+-+-+-+-+-+-+-+-+-+-+-+-+-+-+-+-+-+-+-+-+-+-+-+-+-+-+-+-+-+-+-+-+-+-+-+-+-+-+-+-+-+-+-+-+-+-+-+-+-+-+