+-+-+-+-+-+-+-+-+-+-+-+-+-+-+-+-+-+-+-+-+-+-+
        |             |   |     |           |
+ +-+-+ + +-+-+-+-+-+ + + + +-+ + +-+-+-+-+ +
|   |   |   | |   |   | | | |   | |     | | |
+-+ + +-+-+ + + + + +-+ + + +-+-+ + +-+ + + +
|   |       | | | | |   | |     |     | |   |
+-+-+-+-+-+-+ + +-+ + +-+ +-+-+ +-+ + + +-+-+
|             | |   | |   |   |     | | |   |
+ +-+-+ +-+ + + + +-+ +-+-+ +-+-+-+-+ + + + +
|     | |   |   |   |     |     |     | | | |
+ +-+ + +-+ +-+-+-+ +-+-+ +-+-+ + + +-+ + +-+
| |   |   |       |     |   | |   |   | |   |
+-+ +-+-+ +-+-+-+ + +-+ +-+ + +-+-+-+-+ +-+ +
|   |     |     |   |     | | |   |         |
+ +-+ +-+-+-+-+ +-+-+-+-+ + + + + + +-+-+-+ +
|   | |         |           |   |   |       |
+-+ + + +-+-+-+-+ +-+-+-+ +-+-+ + +-+ +-+-+-+
|   | |   |     | |     |     | | | |     | |
+ +-+ + + + +-+ + + + + +-+-+ + + + +-+-+ + +
|   | | | | | |   | | |       | | |       | |
+-+ + +-+ + + +-+-+ + +-+-+-+-+-+ + +-+-+-+ +
|   |     |   |     |             |          
+-+-+-+-+-+-+-+-+-+-+-+-+-+-+-+-+-+-+-+-+-+-+