+-+-+-+-+-+-+-+-+-+-+-+-+-+-+-+-+-+-+-+-+-+-+-+-+
    |   |     |   |             |         |     |
+ + + + + +-+ + + + +-+-+-+-+-+ + +-+-+-+ + +-+ +
| | | |   |   | | |   |   |   | |     |   | |   |
+ + + +-+-+ +-+ + +-+-+ + + +-+ +-+-+ +-+-+ + +-+
| | | |   | |   |     | | |   | |   |   |   |   |
+ +-+ + + + + +-+-+-+ + + + + + + + +-+ + +-+-+ +
|   | | |     |       | | | |     |   | | |     |
+-+ + +-+-+ +-+ +-+-+-+ + + +-+-+-+-+-+ + +-+-+-+
|   |   | |   |   |     |   |       |   |   |   |
+ +-+-+ + +-+ + +-+ +-+-+-+-+ +-+-+ + +-+-+ + +-+
|     | |   | |     |     |   |     | |   | |   |
+-+-+ + +-+ + +-+-+-+-+-+ + +-+ +-+-+ + + + +-+ +
|     |   | | |     |     | |   |       |   | | |
+ +-+-+-+ + + + +-+ + +-+-+ + +-+-+-+ + +-+-+ + +
| | |   | | |   |   |       |         |         |
+ + + + + + +-+-+ +-+-+ +-+-+-+-+-+-+-+-+ +-+ +-+
| | | | |       | |   | |   |     |   |   | |   |
+ + + + +-+ +-+ + + + + + + + +-+ + +-+ +-+ +-+ +
| |   | |     | |   |   | | |   | |   | |   |   |
+ + + + +-+-+ + +-+-+-+-+-+ +-+-+ + + + + + + +-+
| | | | |   | |     |     | |       | | | |   | |
+ + + + + + + +-+-+ + +-+ + +-+ + +-+-+ + +-+-+ +
|   | |   |   |       |   |     |       |        
+-+-+-+-+-+-+-+-+-+-+-+-+-+-+-+-+-+-+-+-+-+-+-+-+