+-+-+-+-+-+-+-+-+-+-+-+-+-+-+-+-+-+-+-+-+-+-+-+-+-+-+
    |     | |       |   |   |         |             |
+ + +-+-+ + + +-+-+ + +-+ + +-+ +-+-+ +-+-+-+-+-+-+ +
| |   |     |   |   |     |       |     |   |       |
+ +-+ + +-+ +-+ + +-+-+-+-+-+-+-+-+ +-+ + + + + +-+-+
| |   | |   |   | |   |   |     |     |   |   |     |
+ + +-+-+ + + +-+-+ + +-+ + +-+-+ + + +-+-+ +-+-+-+ +
| |       | |       |     |       | |   |   |     | |
+ +-+-+-+-+-+-+-+-+-+-+-+ + +-+-+-+ +-+ +-+-+-+ + +-+
|             |   |     |   |     | | |   | |   |   |
+ +-+-+-+-+-+ + + +-+ + + +-+ +-+ + + +-+ + + + +-+ +
|         | | | |     | | |   | |   |         | | | |
+-+-+-+-+ + + + +-+-+ + + + +-+ + +-+-+-+ +-+-+ + + +
| |   |   |   |     | | | |   |   |       | |   |   |
+ + + + +-+-+-+-+-+-+ + + +-+ +-+-+-+-+-+ + + + +-+-+
|   |   |     |   |   |   |     |   |   | | | | |   |
+-+-+ +-+ +-+ + + + +-+ +-+-+ + + + + + + + + +-+ + +
|   | |   | | | | | |   |     | | |   | |   | |   | |
+ +-+ + + + + + + + + +-+-+-+-+ + +-+ + +-+-+ + +-+ +
| |   | | | | | | | |     |   | | |   |     |   |   |
+ + +-+ +-+ + +-+ + +-+-+ + + + + + +-+-+-+ +-+-+ +-+
| |     |   | |   |   | |   | |   | |           |   |
+ + +-+-+ +-+ + +-+-+ + +-+-+ +-+-+-+ +-+-+-+-+ +-+ +
|   |   |     |     | |   |   |   |   | |   |   |   |
+ +-+ + +-+-+-+ +-+ + + +-+ +-+ + + +-+ + +-+ +-+ +-+
|     |         |     |     |   |       |     |      
+-+-+-+-+-+-+-+-+-+-+-+-+-+-+-+-+-+-+-+-+-+-+-+-+-+-+