+-+-+-+-+-+-+-+-+-+-+-+-+-+-+-+-+-+-+-+-+-+-+-+-+-+-+-+-+
  |     |   |       |     |         |           |       |
+ +-+ +-+ + + + +-+-+ +-+ + +-+-+-+ + +-+-+-+-+ + +-+-+ +
|         |   | |     |   | |     | |     |   | | |   | |
+ + +-+-+-+-+-+ + +-+ + +-+-+ + + + + +-+ +-+ + + + +-+ +
| |     |     | | |   |   |   | |   |   |   | |   |     |
+ +-+-+ +-+-+ + + +-+-+-+ + +-+ + +-+-+ +-+ + +-+-+-+-+-+
|   | |     |   |   |     | | | | |     |   |           |
+-+ + +-+-+ +-+-+-+ +-+-+ + + + +-+ + +-+ +-+-+ +-+-+-+ +
|   |   | |         |     | |       | |   |     |       |
+ +-+-+ + +-+-+ +-+-+ +-+-+ +-+ +-+-+ + +-+ +-+-+ +-+-+ +
|     | |     |     | |     |   |   | |   | | |   |   | |
+-+-+ + +-+ + + +-+-+ + +-+-+-+-+ + + + +-+ + + +-+-+ +-+
| |   |     |   |   | | |     |   | | |     |   |   |   |
+ + + +-+-+-+-+-+ + + + + +-+ +-+ + + +-+-+-+-+-+ + +-+ +
|   | |     |     |   | |   |   | | |   |   |   | | | | |
+-+-+ + + +-+ +-+-+-+-+ +-+ +-+ + +-+-+ + + + + + + + + +
|     | |   | |   |     |     | | |     | | | | | |     |
+ + +-+ +-+ + + + + +-+-+-+-+ + + + +-+-+ + + + +-+ +-+-+
| |   | |   | | |   |         |   | |   | |   |     |   |
+ +-+ + + +-+ + + +-+-+-+-+ +-+-+ + + + + + +-+-+-+-+ + +
|   |   | |   | | |   |   | |   | | | | | | |     |   | |
+ +-+-+-+-+ +-+ + +-+ + + +-+ + + + + + + + +-+-+ +-+-+ +
|     |     |   |   | | |     | | | | | | |   |     |   |
+-+-+ +-+ +-+ +-+-+ + + +-+-+-+ + + + + + +-+ +-+-+ + +-+
| |     |     |   |   | |       | | | |     | |   |     |
+ + + + +-+-+-+ + +-+-+ + +-+-+-+ + + +-+-+ + + + +-+ + +
|   | |         |       |         |   |     |   |     |  
+-+-+-+-+-+-+-+-+-+-+-+-+-+-+-+-+-+-+-+-+-+-+-+-+-+-+-+-+