+-+-+-+-+-+-+-+-+-+-+-+-+-+-+-+-+-+-+-+-+-+-+-+-+-+-+-+-+-+-+
  |   |       |   |       |                       |       | |
+ + + + +-+-+ + + + +-+-+ + +-+-+-+-+-+-+-+-+-+-+ + +-+-+ + +
| | |   |     | |   |   | |     |   |     |   |   | |   | | |
+ + +-+-+ +-+-+ +-+-+ +-+ +-+-+ + + + +-+ +-+ + +-+ + + + + +
|   |     |   |     |   | |   |   | |   |   | | | | | | |   |
+-+-+ +-+-+ +-+-+-+ +-+ + + + +-+-+ +-+ +-+ + + + + + +-+ +-+
|     |   |       |   |     | |   |   | |   | |   | |     | |
+ +-+-+ +-+-+-+-+ + +-+-+ + +-+ + +-+ + + +-+ +-+ + +-+-+-+ +
|       |       |   |   | |   | | | |   |   | |   | |   |   |
+-+-+-+ + +-+-+ +-+-+ + + +-+ +-+ + +-+-+-+ + + +-+ + + + +-+
| |   |   |       | | |   |     | | |     | | | |   | |     |
+ + + +-+-+ +-+-+ + + +-+-+-+-+ + + + +-+ + + + + +-+ +-+-+ +
|   |   |   |     |   |         |     |   | | | |   |   | | |
+ +-+ + +-+-+ +-+-+ +-+ +-+-+-+-+-+-+-+ +-+ + + +-+ +-+ + + +
| | | |       |   | |   |     |     |   |   | |   | |   |   |
+ + + +-+-+-+-+-+ + + +-+ +-+ + +-+-+ +-+ +-+ +-+ + + +-+-+-+
|   |       |     | | |   |   |   |   |       |   |     |   |
+-+-+-+-+-+ + +-+-+ + + +-+ +-+-+ + +-+-+-+-+-+ +-+-+ + + + +
|       |   | | |   |   |   |         |   |   | |   | | | | |
+ +-+ +-+ + + + + +-+-+-+-+-+-+-+ + +-+ + + + + + + + + +-+ +
|   |     | | |   |       |     | |     |   |   | |   | |   |
+-+-+-+-+-+ + + +-+-+-+ + + +-+ + +-+-+-+-+-+-+-+ +-+-+ + +-+
|         |     |   |   | | |   | | |       |     |   | | | |
+ +-+-+-+ +-+ +-+ + +-+-+ + + +-+ + + + +-+ + +-+-+-+ + + + +
|   |     |   |   |       | |         |   | |   |   |     | |
+-+ + +-+-+ +-+ +-+ +-+-+-+ +-+ +-+-+-+-+-+ +-+ + + +-+ +-+ +
|   |       |   |   |   |   | | |           |   | |   | |   |
+ + +-+-+-+-+ + + +-+ + + +-+ + + +-+-+-+-+-+ + +-+-+ + + +-+
| |           | |     |   |     |             |       |      
+-+-+-+-+-+-+-+-+-+-+-+-+-+-+-+-+-+-+-+-+-+-+-+-+-+-+-+-+-+-+