+-+-+-+-+-+-+-+-+-+-+-+-+-+-+-+-+-+-+-+-+-+-+-+-+-+-+-+-+-+-+-+-+-+-+-+-+-+-+-+-+
  |           |       |       |   |     |       |     |   |       | |         | |
+ + +-+-+-+-+ +-+-+ + +-+ +-+ + + + +-+ + +-+-+ + +-+ + + + +-+-+ + + +-+-+-+ + +
|   | |   |   |   | |     | | | | |   | | |     | |   | | | |     |   |         |
+-+-+ + + + + + + + + +-+-+ + + + +-+-+ +-+ + +-+ + +-+-+ + + +-+-+-+-+ +-+-+-+-+
|     | |   | | | | | |   |   | |       |   |     | |     | | |   | |   |   |   |
+ +-+-+ +-+-+-+ + + + + + +-+-+-+ +-+ +-+ +-+-+-+-+ + +-+-+ + +-+ + + +-+ + +-+ +
| |             |   |   |         |   |       |     | |     |   |     |   | |   |
+ +-+-+-+-+-+-+-+ +-+-+-+ +-+-+-+-+-+-+ +-+-+ + +-+-+ + +-+-+-+ +-+-+ + +-+ + +-+
|                 |   |   |   |         |   | |       |     |   |     | |   | | |
+-+-+-+-+-+-+ +-+-+ + +-+ + + +-+-+ +-+-+ + +-+-+-+-+-+-+ + + +-+ +-+ + + + + + +
|           | |   | | |   | |       |     | |     |     | | | |   |   | | | | | |
+ +-+-+-+-+ + + + + +-+ +-+ +-+-+-+-+ +-+-+ + +-+ +-+ +-+ + + + +-+-+-+ +-+ + + +
|         |   | | |     | |     |   |   |   | |   |   |   | |   |   |   |   | | |
+ +-+-+-+ +-+-+ + +-+-+-+ +-+-+ +-+ +-+ + +-+ + +-+ +-+ +-+ +-+-+ + + +-+ + + + +
| |   |         | |           |   |   | |   | | |   |   |   | |   |   |   |     |
+ +-+ + +-+-+-+-+ + +-+-+ +-+-+-+ +-+ + +-+ +-+ + +-+-+-+-+ + + +-+-+-+ +-+-+ +-+
|     |   |     | | |     |   |   | | |   |   |   |     |     | | |   |   |   | |
+-+-+-+-+ + +-+ + + + +-+-+ + +-+ + + +-+ +-+ +-+ + + + + +-+-+ + + + +-+ + +-+ +
|     | | |   | |   |   |   |     | | |   |     | | | |   |     | | |   | |     |
+ +-+ + + +-+ + +-+-+-+ + +-+-+-+-+ + +-+-+ +-+-+ + +-+-+-+ +-+-+ + +-+-+ +-+-+-+
| |     |   | |   |     | |   |     |     | |   | |       | |   | |       |     |
+ +-+-+-+-+ + +-+ + +-+-+ + + + + + +-+-+ + + + + + +-+-+ + +-+ + +-+-+-+-+ + +-+
|           | |   | |   |   |   | | |   |     |   | |   | |     | |   |     |   |
+-+-+-+ +-+-+ + +-+ + + + +-+-+-+ + + +-+-+ +-+-+-+ + + + +-+-+ + + + +-+ +-+-+ +
|     |   |   | |   | | |       | | |     |         | | | |     | | | |   |     |
+ + +-+-+ + +-+ + +-+ + + +-+ + +-+ +-+-+ +-+-+-+ +-+ + + + +-+-+ + + + + + +-+-+
| |     |     | | |   |   |   | |   |       |     |   | |   |       |   | |     |
+ +-+-+ +-+-+-+ + +-+ +-+-+ +-+-+ +-+-+ + + + +-+-+ +-+ +-+-+ +-+-+-+-+-+-+-+-+ +
|   | |         | |   |   |     | |   | | |   |     |   |     |   | |           |
+-+ + +-+-+ +-+-+ + +-+-+ +-+-+ + + + +-+ +-+-+ +-+-+ +-+ +-+-+ + + + +-+-+-+-+-+
|   |   |   |   |   |   | |     | | |   |   |   |   | |   |     |   |   |   |   |
+ + + +-+ +-+-+ + +-+ + + + +-+-+ + +-+ + + + +-+ + + + +-+ +-+-+-+ + + +-+ + + +
| |     | |   | |   | |   | |   |   |   | | | |   | | |   |       |   |   |   | |
+-+-+ + + +-+ + + + + +-+-+ + +-+-+-+ +-+-+ + + +-+ + +-+ +-+-+-+ +-+-+-+ + +-+-+
|   | | |     | | | |   |     |     |         | |   | | | | |     |       | |   |
+ + + + +-+-+-+ + +-+-+ + +-+-+ +-+ +-+-+-+-+-+ +-+-+ + + + + +-+-+ +-+-+-+ + + +
| | | |         |       |   |   |   |           |     | | | |     | |   | |   | |
+ + + +-+-+-+-+-+-+-+ +-+ + + +-+ +-+ +-+-+-+-+ + +-+-+ + + +-+-+ + + + + +-+-+ +
| |   |               |   |   |     |         |           |       |   |          
+-+-+-+-+-+-+-+-+-+-+-+-+-+-+-+-+-+-+-+-+-+-+-+-+-+-+-+-+-+-+-+-+-+-+-+-+-+-+-+-+