+-+-+-+-+-+-+-+-+-+-+-+-+-+-+-+-+-+-+-+-+-+-+-+-+-+-+-+-+-+-+-+-+-+-+-+-+-+-+-+-+-+-+-+-+-+-+-+-+-+-+
  |             |   |   |               |     |       |   |             |     |             |   |   |
+ + +-+-+-+-+-+ + + + + + +-+-+-+ +-+-+ +-+ + + +-+ + +-+ + +-+-+-+-+-+ + +-+ + +-+-+-+-+-+ +-+ + + +
|   |   |     |   | | |   |   |   |     |   | | |   |     |       |   |   |   | |         |   |   | |
+-+-+-+ +-+-+ +-+-+ + +-+-+ + + +-+ +-+-+ + + +-+ +-+-+-+-+ +-+-+ +-+ +-+-+ +-+ + +-+-+-+ + + + +-+ +
|     |     |       |       | |   | |     | |     |       | |     |   |   |   | | |   | | | |   |   |
+ +-+ + +-+ +-+ +-+-+-+-+-+-+ +-+ + + +-+-+ +-+-+-+-+-+-+ + +-+ +-+ +-+ + +-+ + + + + + + +-+-+-+ + +
| |   |   |   | | |   |   |   | | |   |   |   |   |   | |   |   |     | |   | | |   |   |   |     | |
+ + +-+-+-+-+ + + + + +-+ + + + + +-+-+ + +-+ + + + + + + +-+ +-+ + +-+ + +-+ + +-+-+ +-+-+ + +-+-+-+
| |   | |     | |   |       | |       | | |   | | | | | | |   |   | |   |     |         | | |   |   |
+ +-+ + + +-+-+ + +-+-+-+ +-+-+-+-+-+ +-+ + +-+ + + + + +-+ +-+ + +-+ +-+-+-+-+-+-+-+-+ + + + + +-+ +
| | |   | |     |   |     |     |   | |   |   | | | |     | |   |   | |     |       |   |   | |   | |
+ + + +-+ + +-+-+-+ +-+-+-+ +-+ + +-+ + +-+-+ + + + +-+-+ + +-+-+-+ + + +-+ +-+-+-+ + + + +-+ +-+ + +
| | | |   |   |     |       |         | |     | | |   | | |     | |   |   | |     |   | | | | |   | |
+ + + +-+ +-+ + +-+-+ +-+-+-+-+ +-+-+-+ + +-+-+ + +-+ + + +-+-+ + +-+-+-+-+ + +-+ +-+-+-+ + + +-+-+ +
|   |         | |   |     |     |   |   |   | | | |   |       | | | |     |     | | |     | |   |   |
+-+-+-+-+ +-+-+ + +-+ +-+-+ +-+-+ +-+ +-+ + + + + + +-+-+ + +-+ + + + +-+ +-+-+-+ + + +-+-+ +-+ + +-+
|   |       |   |   |   |   |     |     | |   | | | |     | |         |   |       | | |   | |       |
+ + +-+-+-+ + +-+-+ +-+ + +-+ +-+ + +-+-+ +-+ + + +-+ +-+-+-+ + + +-+-+ +-+ +-+-+-+ + + +-+ + +-+-+ +
| |   |   | |       |   | | | |   |   |     | | |   |   |   | | |   |   |   |     | | | |   |   |   |
+ +-+ + +-+ + +-+-+-+ +-+ + + + +-+-+ + + + +-+ +-+ +-+ + + +-+ +-+ + +-+ + + +-+ + + + + +-+-+ + +-+
| | | |   |         | | |     |   |   | | |   |   |     | |   | |   |     | |   | |   | |   | | | | |
+ + + +-+ +-+-+-+-+ + + +-+-+-+-+ + +-+ + +-+ +-+ +-+ +-+ +-+ + +-+-+-+-+-+ +-+ + + +-+ + + + + + + +
| | |     |         |   |   |       |   | | |     | |   |   | |     |   |     | |   |   | |     | | |
+ + + +-+-+ +-+-+-+-+-+-+ + + +-+ +-+ +-+ + +-+-+ + +-+ +-+ + +-+ +-+ + +-+-+-+ +-+-+ +-+-+-+-+-+ + +
|   |     |   |         | |   | |   |   |     | | |   |   | |   |   | | |     |   |   | |     |     |
+-+-+-+-+ + +-+ +-+-+-+ + +-+-+ +-+ +-+ +-+-+ + + +-+ +-+ + +-+ + + +-+ + +-+ +-+ + +-+ + +-+ +-+ +-+
|         |     |       | |   |   | |   | |   | | |   |     | |   |     |   |   | |   | |   | |   | |
+ +-+-+-+ +-+-+-+ +-+-+-+ + + + + + + +-+ + +-+ + + +-+-+ +-+ +-+-+-+-+-+-+ +-+ + + + + +-+ + + +-+ +
| |     |     |   |   |   | | | |   |   | | |   | |     |       |   |         |   | | |     | | |   |
+ + + + +-+-+ + +-+ + + + + + +-+-+-+-+ + + + +-+ +-+-+ +-+-+ + + + + +-+-+-+ +-+-+ +-+-+ +-+-+ + +-+
|   | |     |   | | |   |   | |   |     |   |     |   |   | | |   | |     |   |   |   |     |   | | |
+-+-+-+-+-+ +-+-+ + +-+-+-+-+-+ + + + +-+-+-+ +-+-+ + +-+ + + +-+-+ +-+ +-+ +-+ + +-+ + +-+ + +-+ + +
|       | | |   |   |           |   | |     | |     | |   | | |   |     |   |   | | | |   | |     | |
+ +-+-+ + + + +-+-+-+ +-+-+-+-+-+-+-+-+ +-+ + + +-+-+ + +-+ + + +-+-+ +-+ +-+ +-+ + + +-+ +-+ +-+-+ +
|     |     |       |   |         | |   |   | |   |   | | |   |   | | | |   | | | |   |       |   | |
+-+-+ +-+-+-+ +-+-+-+-+ + +-+-+-+ + + +-+ +-+-+-+ + +-+ + +-+-+-+ + + + +-+ + + + + +-+ + +-+-+-+ + +
|     |     |   |     | |   |   |   | |   |   |   |   |   |   | | |   |     |   | |     |   | |     |
+ +-+-+-+ + +-+ + +-+ + +-+ + +-+-+ + + +-+-+ + +-+-+-+ +-+ + + + + +-+-+-+-+-+-+ +-+-+-+-+ + + + +-+
| |   |   |     | | |   | | |   | |   |   |   | |       |   | |             |   | |           | |   |
+ + +-+ +-+ +-+-+ + +-+-+ + +-+ + +-+-+-+ + +-+ + +-+-+-+-+-+ +-+-+ +-+-+-+ + + + +-+-+ + + +-+ +-+ +
|   |   |   |         | | |   | |   |   |     |     |       | |   |   |   | | |   |   | | |     | | |
+-+ + +-+ +-+-+-+-+-+ + + + + + + + + + +-+ + + + + +-+-+ +-+ + + +-+ + +-+ + +-+-+ + +-+ +-+-+-+ + +
| |   |   |       |   |   | | | | |   |   | |   | |     |   |   |     |     |     | |     |   |   | |
+ +-+-+ + + +-+-+ + +-+ + + + + + +-+-+-+-+ + +-+-+-+-+ +-+ +-+-+-+-+-+-+-+ + +-+ + +-+-+-+-+ + +-+ +
| |     |   |     |   | | | | | |           |   |     |   |       |     |   | |     | |             |
+ + + +-+-+-+ +-+-+-+ + +-+ +-+ + +-+-+-+-+-+-+ + +-+ + + +-+-+-+ + +-+-+ + + + + +-+ + +-+-+-+-+-+-+
|   |   | |     |   | |         | |         |   | | | | |     | | |       | | | |     |   |   |     |
+-+-+-+ + + + + + + + +-+-+ +-+-+ + +-+-+-+ +-+-+ + + +-+-+-+ + + +-+-+-+-+-+ + +-+-+-+-+ + + +-+-+ +
|       |   | |   | |       |     |       |         |             |           |         |   |        
+-+-+-+-+-+-+-+-+-+-+-+-+-+-+-+-+-+-+-+-+-+-+-+-+-+-+-+-+-+-+-+-+-+-+-+-+-+-+-+-+-+-+-+-+-+-+-+-+-+-+