+-+-+-+-+-+-+-+-+-+-+-+-+-+-+-+-+-+-+-+-+-+-+-+-+-+-+-+-+-+-+-+-+-+-+-+-+-+-+-+-+-+-+-+-+-+-+-+-+-+-+-+-+-+-+-+-+-+-+-+-+
  |   |         |       |             |   |   |   |   |   |     |     |       |       |       |                       | |
+ + + + +-+-+-+ + +-+-+ + +-+-+ +-+-+ + + + + + + +-+ + + +-+-+ + +-+-+ +-+-+ + +-+-+ + +-+-+ +-+-+-+ + +-+-+-+-+ +-+ + +
| | | | |     |   |   | | |     | |   | |   | | |   | | |       |       |   | | |   | |   | |   |     | |         |   | |
+ +-+ + + +-+ +-+-+ + + + + +-+-+ + +-+-+-+-+ + + + + + +-+-+-+-+-+-+-+-+-+ + +-+ + + +-+ + +-+ +-+-+ + + +-+-+-+-+ +-+ +
|     | |   |   |   |     | |   |     |         | |   | |   |   |   |       | |   | |     |     |     | |     |     |   |
+ +-+-+-+-+ +-+ +-+-+-+ +-+-+ + + +-+-+ +-+-+ +-+ +-+-+ + +-+ + + + +-+ +-+ + + +-+ +-+-+ +-+-+ + +-+-+-+ +-+ + +-+-+ +-+
| | |   |   |   |   |   | |   | | |   | |       |   |   | |   |   |   |   | | | | |     |   |   | |   |   |   |       | |
+ + + + + +-+ +-+ + + +-+ + +-+ + +-+ + +-+-+ +-+-+ + + + + +-+-+-+-+ +-+-+ + + + +-+-+ +-+-+ + + + + + +-+ +-+-+-+-+-+ +
| |   |   |     | |   |     |   | |   | |   | |     | | | | |     | |   |   | |     |   |   | | |   | |   |   |         |
+ + +-+-+-+ +-+-+ +-+-+ +-+-+ +-+ + +-+ + + + + +-+-+ + + + +-+ + + +-+ + +-+ +-+-+-+ + + + + + +-+-+ +-+ +-+ + +-+ + +-+
| | |   |   |     |   | |     |   | |   | | | | |   | | | |   | | |     |   | |     | |   |   |   | |   | |   | |   |   |
+ + + +-+ +-+ +-+-+ + + +-+-+-+ +-+ + +-+ + +-+ +-+ +-+ + +-+ + + +-+-+-+-+ + + +-+ +-+-+-+-+-+ + + +-+-+ + +-+ +-+-+-+ +
|   |   |         | | |   |     |   |   | |   |   |   |       | |   | |     | |   |   |       | | | |     |   |   |   | |
+-+-+-+ +-+-+-+-+ + + +-+ + +-+-+ +-+-+-+ +-+ + + +-+ +-+ + +-+ +-+ + + + +-+ +-+-+-+ + +-+-+-+ + + + +-+-+-+ +-+ +-+ +-+
|   |   | |       | | |   |   |   |     |   | | | |     | |     |   |   |   | |     | |         |   |     |     |   |   |
+ + + +-+ + +-+-+-+ + + +-+-+ + +-+ +-+ +-+ + + + + + + + +-+-+ + +-+-+ +-+ + + +-+ + +-+-+-+-+-+-+ +-+-+ +-+ +-+-+ +-+ +
| | |   |   |       | | |     |   | | |     | | | | | | | | |   | |   | |   | | |   |     | |   |     |     | |   | |   |
+ + +-+ +-+ + +-+-+-+ + + +-+-+-+ + + +-+-+-+ + + + + +-+ + + +-+ +-+ + + +-+ + + + + +-+ + + + +-+-+ +-+-+ +-+ + + +-+ +
| |         |   |     | | |     | |   |       | | | |     | | |   |   | |   |   | | |   | |   |   |     |       | | |   |
+ +-+-+ +-+-+-+ + + +-+ + +-+ + + +-+-+ +-+-+-+ + +-+-+-+-+ + + +-+ + + +-+-+-+-+-+ +-+ +-+ +-+-+ +-+-+ +-+ +-+-+ + + +-+
|   |   |   |   | |   | |     | |     |   |   | |         | | |     |             |   |   |   | |   |   |   |   | | |   |
+-+ + +-+ + + +-+ +-+-+ +-+-+ +-+ +-+-+-+ + + + +-+-+ + + + + +-+-+-+-+-+-+-+-+-+ +-+ +-+ +-+ + + + + +-+ +-+ + + + +-+ +
| | |     |   | |     | |   | |   |   |   | | | | |   | |   |         |         |             | | | | | |     | | |   | |
+ + +-+-+-+ +-+ +-+-+ + + + +-+ +-+ + + +-+ + + + + +-+ +-+-+-+-+ +-+-+ + +-+-+-+-+-+ +-+-+-+-+ + + + + +-+-+-+-+ +-+ + +
| | |       | |           | |       | |   | |   |   |   |   |   |     | |       |     |     |   | |   |           |   | |
+ + + +-+-+-+ +-+-+-+ +-+-+-+ + +-+-+ +-+ +-+ +-+-+-+-+-+ + + + +-+-+ + +-+-+-+ +-+-+ + +-+ + +-+ +-+-+-+ +-+-+-+ + +-+ +
|   | |     | |       |       |     |   |   |       |     | | |     | |   |   |       | |   |   |     |     |   |     | |
+-+-+-+ +-+ + + +-+ +-+ +-+-+-+-+-+ +-+ +-+ +-+-+-+ + +-+-+ + +-+ +-+ + + + +-+-+-+-+-+-+ +-+ +-+-+-+ + + + + +-+-+ + + +
|       |   |     | |   |         | | |     |       |   |   | |     | | | |     |       | |   |       | | | | |   | | | |
+ +-+-+-+ +-+-+ + +-+ +-+-+-+ +-+ + + + + +-+ +-+-+ +-+ +-+-+ +-+-+ + + +-+-+-+ + +-+-+ + + +-+ +-+-+ + +-+ + + + + + + +
|       |       | |   |     |   | |   | | |   |   |   |       |   | | |         |     |   | |   |     | |   |   |   | | |
+-+-+-+ +-+-+-+-+-+ +-+ +-+ +-+ + +-+-+ + +-+-+ + +-+ +-+-+-+-+ + + + +-+-+-+-+-+-+-+ +-+-+ + + + +-+-+-+ +-+-+-+-+-+ + +
|       |     |     |   | |   | |       |   |   |   | |       | | | |   | |   |     |   | |   | | |     | |   | |     | |
+ +-+-+-+ +-+ + +-+-+-+-+ +-+ + +-+-+-+-+-+ + +-+-+ + + +-+-+-+ + + +-+ + + + + + + +-+ + +-+-+ + + + + + + + + + +-+-+ +
| |   | |   |   |       |   | | |   |   |   | |     |     |   | |   | |   | |   | |   | | |     | | | |   | | | | |   | |
+ + + + +-+ +-+-+-+-+-+ + + + + + + + + + +-+ + +-+-+-+-+ + + + + +-+ + +-+ +-+-+ +-+-+ + +-+-+ + +-+ + +-+ + + + + + + +
| | |   |   |           | | | |   |   | |     |     |   | | |   | |   |   | |   |       | |   | |     | |   |   |   | | |
+ +-+-+ + +-+ +-+-+-+-+-+-+ + + +-+-+-+-+-+ + +-+-+-+ + + + +-+-+-+ +-+-+ + +-+ +-+ +-+-+ + + + +-+-+-+ + +-+ +-+-+-+ + +
|     | | |   |   |   |     | |       |   | | |   |   |   | |       |     |     |       | | | | | |     | |     | |   | |
+-+ + + + + +-+-+ + + + +-+-+ +-+-+-+ + + + + +-+ + +-+-+-+ + +-+-+ + +-+-+ +-+-+ + +-+ + +-+ + + + +-+-+-+ +-+ + + +-+ +
|   |   |       | | |   |     |         | | |               | |   |   |   |   |   | |   |   |   |     |     |   |       |
+ +-+-+-+-+ +-+ + + +-+-+ +-+-+ +-+-+-+-+ + +-+-+-+ +-+-+-+-+ + + +-+-+ + +-+ +-+-+-+ +-+-+ +-+-+-+-+ + +-+-+ +-+-+-+-+-+
|     |   |   |   |     |   |   |   |     | | |     |       | | |     | |       |     | |       |     |   |   |       | |
+-+-+ + + +-+ + +-+-+-+ + + +-+-+ + +-+ +-+ + + +-+-+ +-+ + + + +-+-+ + +-+ +-+ + +-+-+ + +-+-+-+ + +-+-+-+ +-+-+-+ + + +
|   | | | |   | |     |   | |     |   | |   | |     | |   |   | |   |   |   |   |   |   | |       | | |     |   |   |   |
+ + + + + + + + + + +-+-+-+ + +-+-+-+ + +-+ + + +-+ + +-+-+-+-+ + +-+-+-+-+-+ +-+-+ + +-+ +-+-+-+-+ + + +-+-+ + + + +-+ +
| | |   | | | | | |         | |   | |   |   | | |     |   |   | |     |     | |   |     |       |   | | |   | |   | |   |
+-+ +-+-+ + +-+ + +-+-+-+-+-+ + + + +-+-+ +-+ + +-+-+ + + +-+ + +-+-+ + +-+ + + + +-+-+-+-+-+-+ + +-+ + +-+ + +-+-+-+ +-+
|         |   |     |     |     |   |     |   |     | | |       |   |   | | | | |         |   |   |     |   | |       | |
+ +-+-+-+-+-+ +-+-+ + +-+ +-+-+-+ +-+ +-+-+ +-+-+-+ + + +-+-+ + + +-+-+-+ + + +-+-+-+-+-+ +-+ + + + + +-+ +-+ +-+-+-+ + +
|   |         |     | |       |   | | |       |     | | |     | |             |       |       | | | |       | |     |   |
+-+ + +-+-+-+-+ +-+-+ +-+-+-+ + +-+ + + + +-+-+ +-+-+-+ + +-+-+-+-+-+-+-+ + +-+ + + +-+ +-+-+-+ + + +-+-+-+-+ + +-+ + +-+
|   | |       |   | |   |   | | |     | | |   | |   |   |     |   |     | |     | |   |       | |   |     |   |   |   | |
+ +-+ + +-+-+-+-+ + +-+ + + + + + + +-+-+ + + + + + + +-+-+ +-+ + + +-+ + +-+-+-+-+-+ +-+-+ + + +-+-+ + +-+ +-+-+ +-+-+ +
|   | |       |     |   | | | | | |     | | |   | | | | |       | |   |   |     |     |   | | |     | |     |           |
+-+ + +-+-+-+ + + +-+ +-+ +-+ + +-+-+-+ + + +-+-+ + + + + + +-+-+ +-+-+-+-+ + +-+ +-+-+ + + + +-+-+ +-+ +-+-+ +-+-+-+-+-+
|   | | |   |   |   |   |   |   |   |   | | |   | | | |   | | |   |         |     |   | | | |   |   |   |   |     |   | |
+ +-+ + + +-+-+-+-+-+-+ +-+ + +-+ + + +-+ + + + + + + +-+-+ + + +-+ +-+-+-+-+-+-+-+ + + + +-+ + + +-+ +-+ +-+-+-+ + + + +
|     |                     |     | |     |   |   |   |     |     |                 |   |     | |       |           |    
+-+-+-+-+-+-+-+-+-+-+-+-+-+-+-+-+-+-+-+-+-+-+-+-+-+-+-+-+-+-+-+-+-+-+-+-+-+-+-+-+-+-+-+-+-+-+-+-+-+-+-+-+-+-+-+-+-+-+-+-+